# Map created with the OpenAWars Editor
# DO NOT EDIT !!!
classic
15 10
0 0 0 0 0 0 0 0 0 0 0 0 0 0 0
0 0 0 0 0 0 0 0 0 0 0 0 0 0 0
0 0 0 0 0 0 0 0 0 0 0 0 0 0 0
0 0 0 0 0 0 0 0 0 0 0 0 0 0 0
0 0 0 0 0 0 0 55 0 0 0 0 0 0 0
0 0 0 44 44 44 44 44 44 44 44 44 0 0 0
0 0 0 0 51 1 1 1 0 12 0 0 0 0 0
0 0 0 0 0 1 1 1 0 28 0 0 0 0 0
0 0 0 0 0 0 0 0 0 0 0 0 0 0 0
0 0 0 0 0 0 0 0 0 0 0 0 0 0 0
