# This map design is coming from the original OpenWars.
# So, I am supposing that it is licenced by Nintendo
# I am using it just for testing purpose

# Map created with the OpenAWars Editor
# DO NOT EDIT !!!
classic
15 10
# Tiles
92 96 113 113 113 113 132 113 113 113 113 113 113 113 95
96 106 0 1 62 57 40 57 61 0 1 74 0 74 111
112 0 0 1 58 1 116 0 58 91 0 0 73 74 111
112 91 91 62 59 103 133 104 58 0 3 0 58 74 111
112 0 0 58 0 111 96 106 58 91 3 91 58 0 111
112 69 62 59 91 105 106 1 60 57 57 57 63 91 111
112 69 68 0 0 0 0 1 1 0 103 122 41 115 130
94 104 69 69 0 0 0 0 0 0 127 106 0 0 111
92 94 114 104 3 91 3 1 91 0 40 0 91 91 111
92 92 92 94 114 114 114 114 114 114 133 114 114 114 93
# Units
-1 -1 -1 -1 -1 -1 -1 -1 -1 -1 -1 -1 -1 -1 -1
-1 -1 -1 -1 -1 -1 -1 -1 -1 -1 -1 -1 -1 -1 -1
-1 -1 -1 -1 -1 -1 -1 -1 -1 -1 -1 -1 -1 -1 -1
-1 -1 -1 -1 -1 -1 -1 -1 -1 -1 -1 -1 -1 -1 -1
-1 -1 -1 -1 -1 -1 -1 -1 -1 -1 -1 -1 -1 -1 -1
-1 -1 -1 -1 -1 -1 -1 -1 -1 -1 -1 -1 -1 -1 -1
-1 -1 -1 -1 -1 -1 -1 -1 -1 -1 -1 -1 -1 -1 -1
-1 -1 -1 -1 -1 -1 -1 -1 -1 -1 -1 -1 -1 -1 -1
-1 -1 -1 -1 -1 -1 -1 -1 -1 -1 -1 -1 -1 -1 -1
-1 -1 -1 -1 -1 -1 -1 -1 -1 -1 -1 -1 -1 -1 -1
