# This map design is coming from the original OpenWars.
# So, I am supposing that it is licenced by Nintendo
# I am using it just for testing purpose

# Map created with the OpenAWars Editor
# DO NOT EDIT !!!
classic
15 10
# Tiles
93 97 114 114 114 114 133 114 114 114 114 114 114 114 96
97 107 0 1 62 57 40 57 61 0 1 74 0 74 112
113 0 0 1 58 1 117 0 58 92 0 0 73 74 112
113 92 92 62 59 104 134 105 58 0 3 0 58 74 112
113 0 0 58 0 112 97 107 58 92 3 92 58 0 112
113 69 62 59 92 106 107 1 60 57 57 57 63 92 112
113 69 68 0 0 0 0 1 1 0 104 123 41 116 131
95 105 69 69 0 0 0 0 0 0 128 107 0 0 112
93 95 115 105 3 92 3 1 92 0 40 0 92 92 112
93 93 93 95 115 115 115 115 115 115 134 115 115 115 94
# Units
-1 -1 -1 -1 -1 -1 -1 -1 -1 -1 -1 -1 -1 -1 -1
-1 -1 -1 -1 -1 -1 -1 -1 -1 -1 -1 -1 -1 -1 -1
-1 -1 -1 -1 -1 -1 -1 -1 -1 -1 -1 -1 -1 -1 -1
-1 -1 -1 -1 -1 -1 -1 -1 -1 -1 -1 -1 -1 -1 -1
-1 -1 -1 -1 -1 -1 -1 -1 -1 -1 -1 -1 -1 -1 -1
-1 -1 -1 -1 -1 -1 -1 -1 -1 -1 -1 -1 -1 -1 -1
-1 -1 -1 -1 -1 -1 -1 -1 -1 -1 -1 -1 -1 -1 -1
-1 -1 -1 -1 -1 -1 -1 -1 -1 -1 -1 -1 -1 -1 -1
-1 -1 -1 -1 -1 -1 -1 -1 -1 -1 -1 -1 -1 -1 -1
-1 -1 -1 -1 -1 -1 -1 -1 -1 -1 -1 -1 -1 -1 -1
